11111111111111111111
10000000000000100001
1000001000C000000001
10001000C00000110001
10000010001111100001
1P0100000000C00000E1
11111111111111111111