11111111111111111111
10000000000000100001
10000010000000000001
10001000000000110001
10000010001111100001
10010000000000000001
11111111111111111111