11111111111111111111
10000000000000100001
1000111000C00000M001
1000010C1E1000110001
11110011111111100001
1P0000000000C0000001
11111111111111111111
